# # # # # # # # # # # # # # # # # # # # # # # # #
#   #           #       #       #               #
#   # # #   # # #   #   #   #   #   # # # # #   #
#       #       #   #       #       #           #
# # #   # # #   #   # # # # # # # # #   # # #   #
#   #       #       #       #           #       #
#   # # #   #   # # # # #   #   # # # # #   # # #
#           #               #   #   #       #   #
#   # # # # # # # # #   # # #   #   #   # # #   #
#                   #   #       #   #           #
# # # # # # # # #   #   #   # # #   # # # # #   #
#           #       #   #       #       #       #
#   #   # # #   # # #   # # #   #   # # #   # # #
#   #   #       #   #   #   #   #               #
#   # # #   # # #   #   #   #   # # # # # # #   #
#           #       #       #               #   #
#   # # # # #   #   # # #   # # # # # # #   # # #
#       #       #       #       #       #       #
# # #   # # # # # # #   #   # # #   #   #   #   #
#   #       #       #       #       #   #   #   #
#   # # #   #   #   # # # # #   # # #   # # #   #
#           #   #       #       #   #   #       #
#   # # # # #   # # #   #   # # #   #   #   #   #
#               #           #               #   #
# # # # # # # # # # # # # # # # # # # # # # # # #
