# # # # # # # # # # # # # # # # # # # # # # # # # # #
#   #                                   #           #
#   # # #   # # #   # # # # # # # # #   # # #   #   #
#       #       #           #               #   #   #
# # #   # # # # # # # # #   # # # # # # #   # # #   #
#   #                   #               #       #   #
#   # # # # # # # # #   # # # # # # #   # # #   #   #
#               #   #           #       #   #   #   #
# # # # #   #   #   # # # # #   #   # # #   #   #   #
#           #               #   #   #       #   #   #
#   # # # # # # # # # # #   #   #   #   # # #   #   #
#   #   #           #       #       #   #       #   #
#   #   #   # # #   #   # # # # # # #   #   # # #   #
#   #       #       #   #           #       #       #
#   # # #   #   # # #   # # #   #   #   # # # # #   #
#       #   #       #   #       #   #           #   #
#   #   # # #   #   #   #   # # #   # # # # #   #   #
#   #       #   #           #               #   #   #
#   # # #   # # # # # # # # # # # # # # #   #   #   #
#   #       #                       #   #   #       #
# # #   #   #   # # # # # # # # #   #   #   # # #   #
#       #   #       #           #   #   #       #   #
#   # # # # # # #   #   # # #   #   #   #   # # #   #
#   #           #   #       #       #       #       #
#   #   # # #   #   # # #   # # # # # # # # #   # # #
#           #           #                           #
# # # # # # # # # # # # # # # # # # # # # # # # # # #
