# # # # # # # # # # # # # # # # # # # # # # # # # # # # # # # # # # # # # # # # # # # # # # # # # # # # # # # # # # # # # # # # # # # # # # # # # # # # # # # # #
#       #                   #               #                               #       #                   #       #                   #               #           #
# # #   #   # # # # #   # # #   # # #   # # #   # # # # # # # # # # #   #   #   #   #   #   # # # # #   # # #   #   # # #   # # #   #   # # # # #   #   # # #   #
#   #   #   #       #   #       #   #       #       #           #       #   #   #   #   #       #   #       #   #       #   #   #   #       #   #   #   #       #
#   #   #   #   # # #   #   # # #   # # #   # # #   # # # # #   #   # # # # #   #   #   # # #   #   # # #   #   # # #   #   #   #   # # #   #   #   #   #   # # #
#   #   #   #   #       #   #           #           #       #   #               #       #       #                   #   #   #               #       #   #       #
#   #   #   #   #   # # #   # # #   #   # # # # # # #   #   #   # # # # # # # # # # # # #   # # # # # # # # # # #   #   #   # # # # # # # # #   # # # # # # #   #
#       #       #   #       #       #   #   #           #           #       #           #           #       #       #   #                   #               #   #
#   # # # # #   #   #   # # #   # # #   #   #   # # #   # # # # #   #   # # #   #   #   # # # # #   #   #   #   # # #   # # # # # # # # #   # # # # # # #   #   #
#   #           #       #           #   #   #       #       #       #           #   #           #       #   #   #   #   #               #   #   #       #       #
#   # # #   # # # # # # #   # # #   #   #   # # #   # # #   #   # # # # # # # # #   # # # # # # #   # # #   #   #   #   # # #   # # # # #   #   #   #   # # #   #
#       #       #           #       #   #               #   #               #       #           #       #   #       #           #       #   #       #   #       #
# # #   # # #   # # #   # # #   # # #   # # # # # # #   #   # # # # # # #   #   #   #   # # #   # # # # #   # # #   #   # # # # #   #   #   # # # # #   #   # # #
#   #       #       #   #       #   #   #       #       #           #           #   #       #           #       #   #   #           #       #           #       #
#   # # #   # # #   # # #   # # #   #   #   #   # # # # # # # # #   # # # # # # # # # # #   # # # # #   # # #   # # #   #   # # # # # # # # #   # # # # # # #   #
#           #   #       #       #           #                       #       #           #           #       #           #   #       #                       #   #
#   # # # # #   # # #   #   #   #   # # # # # # #   # # # # # # #   #   #   #   # # #   #   # # #   # # #   # # # # # # #   #   #   # # # # # # # # #   # # #   #
#   #               #   #   #   #   #           #   #       #       #   #   #   #       #   #   #   #   #               #   #   #           #       #           #
#   #   # # #   # # #   # # #   # # #   # # #   #   #   #   # # # # #   #   #   #   # # #   #   #   #   # # # # # # #   #   #   # # # # #   #   #   # # # # #   #
#   #       #       #       #   #       #       #   #   #               #       #   #           #   #       #       #   #       #       #       #   #       #   #
#   # # # # # # #   # # #   #   #   # # #   # # # # #   # # # # # # # # # # # # #   # # # # # # #   # # #   #   #   #   #   # # #   # # # # # # #   #   #   # # #
#               #       #       #       #   #           #               #       #   #               #       #   #   #   #           #           #       #       #
# # # # # # #   #   # # # # #   # # #   #   #   # # # # #   #   # # # # #   #   #   #   # # # # # # #   # # #   #   #   # # # # #   #   # # #   #   # # # # #   #
#               #               #   #   #       #       #   #       #       #       #   #                       #   #       #       #       #   #       #       #
#   # # # # # # #   # # # # # # #   #   # # # # #   # # #   # # #   #   # # # # # # #   # # # # #   # # # # # # #   # # #   # # # # # # #   #   # # # # #   #   #
#   #           #   #               #           #               #       #               #       #       #   #           #   #           #   #   #           #   #
#   #   # # #   #   #   # # # # # # #   # # #   # # # # # # # # #   # # #   # # # # # # #   #   # # #   #   #   # # #   #   #   # # #   #   #   #   # # # # #   #
#   #       #   #   #       #       #       #                   #       #       #           #       #       #       #   #       #       #   #       #   #       #
#   # # #   #   #   # # #   #   #   # # #   # # # # # # # # #   # # #   # # #   # # #   # # # # #   # # # # # # #   # # # # # # #   # # #   # # # # #   #   # # #
#           #   #           #   #   #           #               #   #   #       #       #       #                   #           #   #   #       #               #
# # # # # # #   # # #   # # #   #   # # # # # # #   # # # # # # #   #   #   # # #   # # #   #   # # # # # # # # #   #   # # #   #   #   #   #   #   # # # # # # #
#           #       #   #       #   #           #       #       #       #   #       #       #       #               #       #   #   #       #   #       #       #
#   # # #   # # #   # # #   # # #   #   # # #   # # #   # # #   #   # # #   #   # # #   # # # # #   # # # # # # # # #   # # #   #   # # #   #   #   # # #   #   #
#       #       #       #   #   #       #   #       #   #       #   #       #               #   #       #           #   #       #       #   #   #   #       #   #
# # # # #   #   # # #   #   #   # # # # #   # # #   #   #   # # #   #   # # # # # # # # #   #   # # #   #   # # #   #   #   # # # # #   #   #   # # #   # # #   #
#           #   #   #   #   #       #           #   #   #           #   #               #   #       #           #       #   #           #   #           #       #
#   # # # # #   #   #   #   #   #   # # #   #   #   #   #   # # # # #   #   # # # # #   #   # # #   # # # # # # # # # # #   #   # # # # # # # # # # # # #   #   #
#   #       #   #   #       #   #   #       #   #       #           #   #   #   #       #       #           #               #                           #   #   #
#   #   #   #   #   # # # # #   #   #   #   # # # # # # # # # # #   #   #   #   #   # # # # #   #   # # #   #   # # # # #   # # # # # # # # # # # # #   #   #   #
#   #   #               #       #       #   #               #   #   #       #   #   #       #   #       #   #   #       #       #               #       #   #   #
#   # # # # # # # # #   #   #   # # # # # # #   # # #   #   #   #   #   # # #   #   # # #   #   # # # # #   #   #   #   # # #   #   # # # # #   #   # # #   #   #
#           #       #   #   #                   #       #       #   #           #   #       #           #   #   #   #           #           #   #       #   #   #
#   # # #   # # #   #   # # # # # # # # # # # # #   # # # # # # #   # # # # #   #   #   #   # # # # #   #   #   #   # # # # # # # # # # # # #   # # #   #   #   #
#       #       #       #       #                   #           #   #       #   #   #   #       #           #   #           #           #           #       #   #
# # #   # # #   #   # # #   #   #   # # # # # # #   #   # # #   #   #   #   # # #   #   # # # # #   # # # # #   # # # # #   # # #   #   #   # # #   # # # # #   #
#   #       #   #           #       #               #   #   #   #   #   #           #       #           #       #       #           #       #   #   #           #
#   #   # # #   #   # # # # # # # # # # # # #   # # #   #   #   #   #   # # # # # # #   #   #   # # # # #   # # #   #   # # # # # # # # # # #   #   #   # # # # #
#   #   #       #   #       #               #   #   #   #   #       #       #       #   #       #           #   #   #   #                           #           #
#   #   #   # # # # #   #   #   # # # # #   #   #   #   #   # # # # # # #   #   # # #   # # # # #   # # # # #   #   #   #   # # # # # # #   # # # # # # # # #   #
#   #   #       #       #   #           #   #       #   #                   #           #   #       #               #       #           #   #               #   #
#   #   # # #   #   # # #   # # # # #   #   # # # # #   #   # # #   # # # # #   # # # # #   #   # # #   # # # # # # # # # # #   # # #   #   #   #   # # # # #   #
#       #       #       #               #               #   #       #   #       #           #   #                       #       #       #   #   #           #   #
#   # # #   # # # # #   # # # # # # # # # # # # # # # # # # #   # # #   #   # # #   # # # # #   # # # # # # # # # # # # #   # # #   # # # # #   # # # # #   #   #
#       #           #   #   #                       #           #           #           #       #               #           #   #               #           #   #
# # #   # # #   #   #   #   #   # # # # # # #   #   #   #   # # #   # # # # # # # # #   #   # # #   # # # # #   #   # # # # #   # # # # # # # # #   # # # # #   #
#       #       #   #   #   #   #           #   #   #   #   #                           #   #       #           #   #                           #   #           #
#   # # #   # # # # #   #   #   #   # # #   #   # # #   #   # # # # #   # # # # # # #   #   #   # # #   # # # # #   # # # # # # #   # # #   #   #   #   # # # # #
#   #   #               #   #   #       #       #       #   #       #   #           #   #       #   #           #               #   #   #   #   #       #       #
#   #   # # # # # # # # #   #   # # #   # # # # #   # # #   #   #   # # #   # # #   #   # # # # #   # # # # #   # # # # # # #   #   #   #   # # # # # # #   # # #
#   #                   #       #   #               #   #       #       #   #   #   #           #           #   #           #   #       #           #           #
#   # # # # # # # # #   #   # # #   # # # # # # # # #   # # # # # # #   #   #   #   # # # # #   # # #   #   #   #   #   # # #   # # #   # # #   #   # # # # #   #
#       #               #       #                       #           #   #       #           #   #       #   #       #           #       #       #       #       #
# # #   #   # # # # #   # # #   # # # # # # # # # # #   #   # # #   #   # # #   # # # # #   #   #   # # #   # # # # # # # # # # #   # # #   # # # # #   #   #   #
#   #   #           #       #       #                   #       #   #       #           #   #   #       #   #                   #       #   #       #       #   #
#   #   #   # # #   # # #   # # #   #   # # # # # # #   # # #   #   #   #   #   # # # # #   #   # # #   #   #   # # # # # # #   # # # # #   #   #   #   # # # # #
#       #   #   #   #       #       #   #   #               #   #   #   #   #   #           #       #   #   #           #   #       #       #   #   #   #       #
#   # # #   #   #   # # # # #   # # #   #   #   # # # # # # #   #   #   #   #   #   # # # # # # #   #   #   #   # # #   #   # # #   #   # # #   #   # # #   #   #
#   #   #   #   #   #                   #               #       #   #   #       #   #               #   #   #       #   #       #   #           #           #   #
#   #   #   #   #   #   # # # # # # # # #   # # # # # # #   # # #   # # #   # # #   #   # # # # # # #   #   # # # # #   #   # # #   # # #   # # # # # # # # #   #
#   #   #   #   #       #               #   #           #   #   #       #   #   #   #       #           #   #       #   #       #       #   #       #       #   #
#   #   #   #   # # # # #   # # # # #   #   #   # # #   #   #   # # #   #   #   #   # # #   #   # # # # #   #   #   #   # # #   # # #   #   # # #   #   #   #   #
#   #       #           #   #   #       #   #       #       #       #   #       #   #       #   #       #   #   #       #       #       #           #   #       #
#   # # #   #   # # # # #   #   #   # # # # # # #   # # # # #   #   #   # # # # #   #   # # #   #   # # #   #   # # # # #   # # #   # # #   # # # # #   # # #   #
#       #       #           #       #           #       #       #   #       #       #   #       #           #           #   #       #       #       #   #       #
# # #   # # # # #   # # # # #   # # #   # # #   # # #   #   # # #   # # #   #   # # #   # # #   #   # # # # # # #   #   #   #   # # # # # # #   #   #   #   # # #
#   #           #       #       #       #   #       #   #       #           #       #   #       #   #           #   #   #   #   #       #       #   #   #       #
#   # # # # #   # # #   # # #   #   # # #   # # #   #   # # #   # # # # # # # # #   #   #   # # #   #   #   #   # # #   #   #   #   #   #   # # #   #   # # #   #
#           #       #       #       #           #       #   #       #               #       #   #   #   #   #       #   #   #   #   #       #   #       #       #
#   #   # # # # #   # # #   # # # # #   # # # # # # # # #   # # #   # # #   # # # # # # # # #   #   # # #   # # #   #   #   #   #   # # # # #   # # # # #   # # #
#   #                       #                                               #                               #           #           #                           #
# # # # # # # # # # # # # # # # # # # # # # # # # # # # # # # # # # # # # # # # # # # # # # # # # # # # # # # # # # # # # # # # # # # # # # # # # # # # # # # # #
