# # # # # # # # #
#       #       #
# # #   #   #   #
#   #       #   #
#   # # # # #   #
#           #   #
#   # # # # #   #
#               #
# # # # # # # # #
