# # # # # # # # # # #
#               #   #
# # # # # # #   #   #
#               #   #
#   # # # # # # #   #
#   #           #   #
#   #   # # #   #   #
#   #       #   #   #
#   # # #   #   #   #
#           #       #
# # # # # # # # # # #
